########
#*    *#
# #$$  #
# $*@# #
# # *$ #
#  $$# #
#*    *#
########