########
# $* $*#
#@*$ $*#
# $* $*#
# *$ $*#
########