###########
####  @   #
####$ $$# #
#  $*#**# #
#  #*$**$ #
# $#**### #
#  $ $### #
##       *#
###########