#############################
###  #  ####  #  ####  #  ###
## $***$ ## $***$ ## $***$ ##
# $* $#*$  $*#$ *$  $* $#*$ #
#  *$ $* #$ *$ $* $# *$ $*  #
## * # * ** *   * ** * # *@##
#  *$ $* $# *$ $* #$ *$ $*  #
# $*#$ *$  $* $#*$  $*#$ *$ #
## $***$ ## $***$ ## $***$ ##
###  #  ####  #  ####  #  ###
#############################