######
# ** #
#  $ #
# #@*#
# $$##
# # ##
#    #
######