#############
#      ######
#   $  #  . #
# @    # .. #
# $    # .  #
#### ###....#
#     ### ###
# $ $ #   $ #
#        $  #
#  $  # $   #
#     #     #
#############