###############
#######*#######
#######*#######
###         ###
##  # # # #  ##
#  ##     ## ##
# ##  # #  ## #
#     $@$     #
###############