############
####    ####
#### ##$####
# **$  **  #
# # #$#### #
#    $@    #
#     #    #
############