#############
#        #  #
# @   $  #  #
#    ### #  #
#   $***$#  #
#  #$***$   #
#  # ###    #
#  #  $     #
#  #        #
#############