
 #################### 
##                  # 
#    $ $ #  $   $$  # 
#  $ #######$ ###   # 
#  #   $      ## $$ # 
#  #   $ $  @ ##  # # 
#  # ###### $$#  $  # 
#  #  ****#      #### 
#     ****#    $  **# 
#     ****# $ ##### ##
#  ## # ###$$        #
#           $     #  #
# ## #  #       ###  #
#       ## ## #    **#
#    #**    #      **#
######################