###############
#######*#######
#######*#######
###         ###
##  # # # #  ##
#  ##     ##  #
# ##  # #  ## #
#     $@$     #
####  ###  ####
###############